Iteration,Density,CheckPoints,CellularIterations,Height,Width,ReplanningTime_Level1,ReplanningTime_AStar,PathLengthChange_Level1,PathLengthChange_AStar
1,57,2,6,100,100,3,0,196,161
2,55,1,7,100,100,0,1,0,161
3,60,3,5,100,100,0,3,0,0
4,61,4,5,100,100,0,0,0,0
5,53,3,7,100,100,1,2,201,161
6,59,1,5,100,100,1,11,0,0
7,53,2,7,100,100,0,40,0,0
8,59,1,6,100,100,0,0,0,0
9,53,2,7,100,100,1,49,0,0
10,58,2,5,100,100,0,1,0,0
